S2 4 4 3 3
 2 3 3 2 3
 3 2 3 1 3
 2 2 3 2 1
 1 4 4 4 X
